Xabsorbe: absorb
Xabsürt: absurd
Xacele et: hurry
aciz: unable
Xacı: bitter
Xacımasız: cruel
Xacıt: hurt
acı çek: suffer
ada: island
XKendini ada: devote
xadapteet: adapt
aday: nominee
adres: address
Xadım: step
Xaerobik: aerobic
Xafiş: banner
ahbap: buddy
ahlaki: moral
Xhatırla: remember
aile: family
Xaile: parent
ajan: agent
akrep: scorpion
aksiyon: action
aktris: actress
Xaktör: actor
akustik: acoustic
Xakçaağaç: maple
Xakıl: mind
Xakıllı: clever
Xakıllı: smart
Xakşamyemeği: dinner
Xal: receive
alan: area
Xalan: field
Xalan: zone
Xalarm: alarm
Xalbüm: album
alet: gadget
alev: flame
alfa: alpha
alkol: alcohol
Xalkış: clap
Xalt: bottom
altı: six
Xaltın: gold
Xaltında: below
Xalıcı: buyer
Xalımsatım: trade
Xalıntı: quote
Xalışkanlık: habit
Xamatör: amateur
Xamaç: purpose
amca: uncle
ampul: bulb
Xan: moment
Xana: main
anahtar: key
analist: analyst
Xangaje et: engage
Xani: rapid
Xani: sudden
anket: survey
anlam: mean
Xanlat: tell
Xanlaşmak: deal
anne: mom
Xanne: mother
Xanten: antenna
Xantik: ancient
antika: antique
aptal: silly
Xara: search
araba: car
Xaraba: cart
aralık: december
Xaramak: dial
Xaramayapmak: call
Xarasında: among
Xarasında: between
Xaraç: tool
Xaraç: vehicle
Xaraştır: seek
Xarena: arena
arka: behind
Xarkadaş: friend
arktik: arctic
armut: pear
Xartır: increase
Xartır: boost
Xartır: raise
arz: supply
Xarıkümesi: swarm
Xarıza: fault
Xasansör: elevator
asil: royal
asit: acid
asker: soldier
asla: never
Xaslan: lion
Xastım: asthma
Xat: horse
Xat: toss
atak: strike
Xateş: fever
Xateş: fire
Xateşet: shoot
atlet: athlete
Xatom: atom
Xatık: waste
Xatıştırmalık: snack
avla: hunt
avokado: avocado
Xay: month
Xay: moon
ayak: foot
Xayakkabı: shoe
Xayaklanma: riot
ayarla: adjust
ayna: mirror
Xaynı: same
Xaynıfikirdeolmamak: disagree
Xayrı: apart
Xayrı: spare
Xayrıca: also
Xayrıl: leave
Xayrıl: split
Xayrılış: depart
Xayyıldızı: lunar
azalt: reduce
Xazaltmak: decrease
azletmek: dismiss
Xaç: hungry
Xaçı: angle
Xaçık: net
Xaçık: open
Xaçıkarttırma: auction
Xaçıklamak: clarify
Xaçıklamak: explain
Xaçıklık: gap
Xaçılmak: unfold
Xağ: network
Xağ: web
Xağaç: tree
Xağlamak: cry
Xağustos: august
Xağır: heavy
Xaşağıda: under
Xaşk: love
Xaşçı: cook
Xaşınmak: erode
Xaşırı: excess
baba: dad
Xbaba: father
Xbaca: chimney(bacak daha iyi)
bacak: leg
bagaj: luggage
bahar: spring
Xbaharat: spice
Xbahçe: garden
Xbahçe: yard
Xbahşiş: tip
bakkal: grocery
Xçocuk bak: foster
Xbakır: copper
Xbakış: gaze
Xbakış: glimpse
Xbakışat: glance
Xbakışaçısı: aspect
Xbal: honey
balina: whale
balkon: balcony
Xbalık: fish
bambu: bamboo
baraka: shed
bardak: cup
bariz: obvious
Xbarış: peace
Xbas: print
basit: simple
Xbataklık: swamp
Xbatmadan yüz: float
Xbattaniye: blanket
Xbatı: west
bayan: lady
bayrak: flag
Xbayıl: faint
Xbaz: base
Xbağla: bind
Xbağlamak: connect
Xbağlantı: link
Xbağlıolmak: depend
Xbağımlı: addict
Xbağışyapmak: donate
Xbağışçı: donor
Xbağışıklık: immune
Xbaş: chief
Xbaşak: spike
Xbaşar: achieve
Xbaşar: prosper
Xbaşarı: success
Xbaşka: else
Xbaşkent: capital
Xbaşla: begin
Xbaşla: start
Xbaşlık: title
Xbaşlık: topic
Xbaşparmak: thumb
Xbaşparmak: toe
Xbaşıdönmek: dizzy
bebek: baby
Xbebek: infant
bekleme: wait
Xbeklemek: expect
bela: trouble
belge: document
belirsiz: obscure
Xbelirsiz: vague
Xbelirt: indicate
Xbenze: resemble
benzer: similar
berbat: awful
beri: since
besle: feed
betimlemek: describe
beyin: brain
Xbeğen: like
Xbeşik: cradle
biber: pepper
biftek: steak
Xbil: know
bilek: ankle
Xbilek: wrist
Xbilet: ticket
bilge: wise
Xbilgelik: wisdom
Xbilgiver: inform
bilim: science
Xbilinmeyen: unknown
Xbiniş: embark
Xbir: one
biraz: little
Xbirebir aynı: exact
Xbiriktirmek: collect(birim daha iyi)
birim: unit
Xbirinci: first
Xbirisi: someone
Xbirkaç: few
Xbirkere: once
Xbirleştir: merge
Xbirleştirmek: combine
birlikte: together
bisiklet: bicycle
biyoloji: biology
bluz: blouse
bobin: coil
Xbomba: bomb
Xbonus: bonus
Xborç: loan
Xborçal: borrow
Xbot: boat
boyun: neck
boyut: size
Xbozulmamış: intact
Xboş: empty
Xboş: vacant
Xboşanmak: divorce
Xboşluk: slot
Xboşluk: void
Xboşta: idle
Xboşvakit: leisure
brokoli: broccoli
Xbronz: bronze
Xbu: this
Xbu akşam: tonight
bufalo: buffalo
Xbugün: today
buhar: vapor
Xbul: find
Xbul: found
Xbulanıklaştır: blur
bulut: cloud
Xburger: burger
burun: nose
Xbuz: ice
Xbuğday: wheat
Xböbrek: kidney
Xböcek: insect
Xbölge: region
Xbölmek: divide
Xbölüm: chapter
Xbölüm: episode
Xbölüm: section
Xböyle: such
Xbüfe: cupboard
Xbütçe: budget
Xbütün: entire
Xbüyü: grow
Xbüyük: huge
Xbüyük: large
Xbüyük: magic
Xbüyüklük: vast
Xbüyükpatlama: blast
Xbırak: quit
Xbıçak: knife
Xbıçakağzı: blade
Xcam: glass
canavar: monster
Xcanlı: brisk
Xcanlı: live
Xcanlı: vibrant
Xcanlı: vivid
casus: spy
Xcaz: jazz
ceket: jacket
cesur: brave
Xcesur: daring
cevap: answer
ceviz: nut
Xceviz: walnut
ceza: penalty
cezbet: attract
cihaz: device
cilt: skin
Xcüce: dwarf
Xcümle: sentence
Xcümlegrubu: phrase
daha: more
Xdahaiyi: better
Xdahasonra: later
Xdâhi: genius
daire: circle
dakika: minute
dalga: wave
Xdalgalanma: ripple
dalma: plunge
damga: stamp
damlamak: drip
dans: dance
Xdar: narrow
darbe: impact
dava: case
Xdava: lawsuit
Xdavetet: invite
davran: behave
Xdavran: treat
Xdavranış: attitude
davul: drum
Xdağ: mountain
Xdağılım: scatter
debriyaj: clutch
dedikodu: gossip
deli: crazy
Xdelik: hole
Xdel: drill
demiryolu: rail
dene: try
Xdenetim: audit
denge: balance
deniz: marine
Xdeniz: sea
dere: creek
Xdere: river
Xderece: degree
derinlik: depth
ders: lecture
Xders: lesson
destekle: uphold
detay: detail
Xdevamsız: absent
devasa: giant
devekuşu: ostrich
devlet: state
Xdevril: topple
devrim: reform
Xdevriye: patrol
Xdeğer: worth
Xdeğin: mention
Xdeğiştir: alter
Xdeğiştir: modify
Xdeğiştirmek: change
Xdeğiştokuş: swap
dijital: digital
dikkat: caution
Xdikkatealmak: consider
Xdikkatedeğer: notable
Xdil: language
Xdil: tongue
dilek: wish
dilim: slice
dinamik: dynamic
dinozor: dinosaur
diren: resist
dirsek: elbow
diyagram: diagram
diyet: diet
Xdiz: knee
dizel: diesel
dizin: index
Xdizüstübilgisayar: laptop
Xdiğer: another
Xdiğer: other
Xdiş: tooth
Xdişhekimi: dentist
Xdişi: female
doktor: doctor
Xdolaşmak: cruise
Xdolma kalem: pen
domates: tomato
domuz: pig
Xdomuzpastırması: bacon
Xdon: frost
donatmak: equip
Xdondurulmuş: frozen
dosya: file
Xdoz: dose
Xdoğa: nature
Xdoğal: neutral
Xdoğru: correct
Xdoğru: true
Xdoğrudan: direct
Xdoğrula: verify
Xdoğu: east
Xdoğu: orient
Xdoğum: birth
Xdrama: drama
duman: smoke
Xdur: stand
durakla: pause
Xduruşma: trial
duvar: wall
duygu: emotion
duyur: announce
Xdön: turn
Xdöndür: rotate
Xdöndür: spin
Xdönem: term
Xdöngü: cycle
Xdöngü: loop
Xdönme: twist
Xdövme: tattoo
Xdöşe: pave
Xdöşeme: slab
Xdükkan: shop
Xdünya: world
Xdürtü: impulse
Xdürtü: urge
Xdürüm: wrap
Xdüz: flat
Xdüzelt: fix
Xdüzenle: arrange
Xdüzenle: edit
Xdüzenle: install
Xdüzenle: sort
Xdüzenli: regular
Xdüzensizlik: disorder
Xdüğme: switch
Xdüğün: wedding
Xdüş: fall
Xdüşman: enemy
Xdüşünce: thought
Xdüşürmek: drop
Xdış: outer
Xdışmekan: outdoor
Xdıştan: outside
edepsiz: nasty
edin: obtain
efsane: legend
Xefsane: myth
egzotik: exotic
Xegzoz: exhaust
ejderha: dragon
ekim: october
ekle: add
ekmek: bread
Xeko: echo
ekoloji: ecology
ekonomi: economy
ekran: screen
eksen: axis
ekstra: extra
Xel: hand
elbise: dress
Xelbise: gown
Xeldeetm: acquire
eldiven: glove
elektrik: electric
eleman: staff
Xeleştirmen: critic
elma: apple
Xelmas: diamond
Xel çantası: purse
Xemekli ol: retire
emin: sure
Xeminolmak: ensure
emir: order
Xempoze et: impose
Xendişe: anxiety
Xendişe: worry
Xendüstri: industry
Xenerji: energy
engel: hurdle
Xen iyi: best
Xenjekte et: inject
enkaz: debris
Xenkaz: wreck
erit: melt
Xerişim: access
erkek: man
Xerkek kardeş: brother
Xerkek çocuk: boy
Xerken: early
erozyon: erosion
eser: artefact
eski: old
Xet: meat
etek: skirt
Xetik: ethics(etek e benziyor)
etiket: label
Xetiket: tag
Xetrafında: around
Xev: home
Xevcilhayvan: pet
evlilik: marriage
evren: universe
Xevrim geçirmek: evolve
Xev sahibi: host
Xezmek: crush
Xeğim: tilt
Xeğit: train
Xeğitimver: educate
Xeğlen: amused
Xeğlence: fun
Xeğlenceli: funny
Xeğri: curve
Xeş: wife
Xeşek: donkey
Xeşit: equal
Xeşsiz: genuine
Xeşsiz: unique
faiz: interest
Xfakülte: faculty
Xfan: fan
Xfantezi: fantasy
fare: mouse
farket: notice
Xfarklılık: differ
Xfarkında ol: aware
Xfarz et: assume
fasulye: bean
Xfavori: favorite
fayda: benefit
Xfayda: utility
fazla: much
Xfederal: federal
fener: torch
Xfestival: festival
Xfigür: figure
fiil: verb
fikir: idea
Xfikir: opinion
Xfil: elephant
Xfildişi: ivory
Xfilm: film
Xfilm: movie
Xfiltre: filter
Xfirma: firm
Xfitness: fitness
fiyat: price
fiziksel: physical
Xflaş: flash
folyo: foil
Xforum: forum
fosil: fossil
Xfotoğraf: photo
futbol: soccer
fırlat: throw
Xfırçala: brush
Xfırçalama: scrub
Xfırın: furnace
Xfırın: oven
Xfıstık: peanut
Xfısılda: whisper
Xgalaksi: galaxy
galeri: gallery
garaj: garage
garip: awkward
Xgarip: weird
Xgaz: gas
gazi: veteran
gece: night
Xgece yarısı: midnight
gecikme: delay
gelecek: future
Xgelenek: custom(gelecek ile çok benziyor)
gelgit: tide
gelincik: weasel
gelir: income
Xgeliş: thrive
Xgeliştir: improve
Xgeliştirmek: develop
Xgel: come
gemi: ship
Xgemi: vessel
genel: general
Xgeniş: wide
Xgenişlet: enhance
Xgenişletmek: expand
Xgenişlik: width
Xgenç: young
Xgençlik: youth
gerek: require
Xgeri al: undo
Xgeri dön: return
Xgeri dönüşüm: recycle
Xgeriye kalan: remain
Xgeri çekil: retreat
Xgerçek: actual
Xgerçek: real
Xgerçek: truth
Xgerçekten: truly
getir: bring
geyik: deer
Xgez: travel
gezegen: planet
gezi: trip
Xgeç: pass
Xgeçerli: valid
Xgeçerli: viable
Xgeçit: gate
Xgeçittöreni: parade
Xgeçmek: cross
Xgidip getir: fetch
Xgiriş: entry
Xgiriş: input
Xgirişim: venture
Xgir: enter
gitar: guitar
giysi: garment
Xgiysi: wear
gizem: mystery
Xgizlenmiş: hidden
gizli: secret
Xgoril: gorilla
grup: group
gurur: pride
Xgururlu: proud
Xgöl: lake
Xgölet: pond
Xgölge: shadow
Xgönder: submit
Xgörev: duty
Xgörev: task
Xgörkem: glory
Xgörmezdengel: ignore
Xgörsel: visual
Xgörün: appear
Xgörüntülemek: display
Xgörünüş: sight
Xgörüş: view
Xgöz: eye
Xgözboyama: pitch
Xgözdengeçir: review
Xgözkırp: wink
Xgözlemle: observe
Xgöğüs: chest
Xgücüyetmek: afford
Xgül: laugh
Xgül: rose
Xgülümse: smile
Xgümüş: silver
Xgün: day
Xgünbatımı: sunset
Xgüncelleme: update
Xgüncelleme: upgrade
Xgündelik: casual
Xgüney: south
Xgüneş: sun
Xgüneşli: sunny
Xgünlük: diary
Xgüreş: wrestle
Xgürültü: noise
Xgüven: rely
Xgüven: trust
Xgüvenli: safe
Xgüvenlik: security
Xgüvercin: dove
Xgüvercin: pigeon
Xgüzel: nice
Xgüzellik: beauty
Xgüç: force
Xgüç: power
Xgüçlendir: empower
Xgüçlü: robust
Xgüçlü: strong
haberler: news
Xhabersiz: unaware
hafif: slight
Xhafta sonu: weekend
Xhafıza: memory
Xhakkında: about
Xhaksız: unfair
hala: aunt
Xhâla(aşapkalı): still
Xhaline gel: become
Xhalı: carpet
Xham: raw
Xhamster: hamster
Xhap: pill
hapishane: prison
harca: spend
hareket: motion
Xhareket: move
Xhareketegeç: act
harika: great
Xhariçtutmak: exclude
harp: warfare
Xharç: tuition
Xhasat: harvest (hasta daha iyi)
hasta: ill
Xhasta: patient
Xhasta: sick
Xhastalık: disease
Xhastalık: illness
Xhastane: hospital
hata: error
Xhata: mistake
Xhatırla: recall
Xhatırlat: remind
hava: air
Xhava: weather
Xhavaalanı: airport
havuz: pool
Xhayalet: ghost(hayat daha iyi)
hayat: life
Xhayati: crucial
Xhayati: vital
hayvan: animal
Xhayvanatbahçesi: zoo
Xhazır: ready
Xhazırlan: prepare
hecele: spell
hedef: aim
Xhedef: target
hediye: gift
Xhediye: present
Xhemşire: nurse
hepsi: all
herhangi: any
Xherhangi biri: either
Xher zaman: always
hesap: account
hevesli: keen
heyecanlan: excite
Xhibe et: grant
hikaye: story
hindi: turkey
Xhindistancevizi: coconut
Xhis: sense
hisset: feel
hizmet: service
Xhizmetçi: maid
Xhiçbiri: neither
Xhiçbir şey: nothing
hobi: hobby
hokey: hockey
Xhollandaca: dutch
homurtu: grunt
Xhoşgeldin: welcome
hurda: junk
Xhurda: scrap
Xhız: speed
iddia: claim
Xifade etmek: express
ihanet: betray
Xihmal etmek: neglect
Xihtisas: domain(Arapça mı)
Xihtiyaç: need
Xiki: two
Xiki kere: twice
ikilem: dilemma
ikinci: second
ikiz: twin
Xikna etmek: convince
ileri: forward
Xileri: toward
Xilerle: advance
Xilham ver: inspire
Xilişki: affair
Xilk: initial
inan: believe
Xinanç: faith
Xinanılmaz: amazing
Xinanılmaz: insane
ince: slender
Xincinme: injury (mekmak mı yoksa incinme kelimesi mi)
inkar: denial
insan: human
Xinsanlar: people
Xinç: inch
Xinşa et: build
ipek: silk
Xiptal etmek: cancel
ipucu: hint
isim: name
istek: want
Xistek: will
Xistekli: eager
istiridye: oyster
Xisyancı: rebel
Xit: push
itaat: obey
itibar: dignity
Xitiraf et: admit
Xiyi: fine
Xiyi: good
izci: scout
izin: permit
Xizin ver: allow
izle: track
izole: isolate
Xiç: inner
Xiçer: involve
Xiçeri: inside
Xiçine: into
Xiçmek: drink
Xiçmekan: indoor
Xiğne: sting
Xiş: job
Xiş: work
Xişaret: sign
Xişgücü: labor
Xişletme: business
Xjaguar: jaguar
Xjest yap: gesture
jeton: token
Xjöle: jelly
kaba: rough
Xkaba: rude
Xkabak: pumpkin
Xkabarcık: bubble
kabile: tribe
kabin: cabin
kablo: cable
kabuk: shell
Xkaburga: rib
kadar: until
kadife: velvet
Xkadın: woman
kafa: head
Xkafa tası: skull
kafes: cage
Xkafes: grid
kahraman: hero
kahve: coffee
Xkahve rengi: brown
Xkaktüs: cactus
Xkal: stay
Xkalabalık: crowd
Xkaldır: lift
Xkaldır: remove
kale: castle
kalite: quality
kalkan: shield
kalp: heart
Xkalça: hip
kamera: camera
kamp: camp
kamu: public
kamyonet: truck
Xkamyonet: van
Xkan: blood
kanal: canal
Xkanat: wing(kanalla çok benzer)
kanepe: couch
kanguru: kangaroo
kano: canoe
kanun: law
kanyon: canyon
Xkanıt: evidence
Xkanıt: proof
kaos: chaos
kapak: cover
Xkapalı: close
Xkapalı: off
Xkapan: trap (kapakla) benzer
kaplan: tiger
Xkaplumbağa: tortoise
Xkaplumbağa: turtle
kaptan: captain
Xkapüşon: hood
Xkapı: door
Xkapı çal: knock
Xkar: snow
kXarar vermek: decide
karbon: carbon
Xkardeş: sibling
kare: square
kargo: cargo
karides: shrimp
karma: hybrid
kart: card
kartal: eagle
Xkarıştır: shuffle
Xkarışık: mixed
Xkarışım: mix
Xkarışım: mixture
Xkarşılıklı: mutual
Xkarşısında: across
Xkarşıçık: oppose
Xkas: muscle
kasa: vault
Xkask: helmet (Kasa ile benzer)
kasvet: gloom
Xkasvetli: bleak
Xkasırga: tornado
Xkat: include
katalog: catalog
kategori: category
Xkâtip: clerk
katla: fold
katman: layer
Xkatı: rigid
Xkatı: solid
Xkatıl: agree
Xkatıl: attend
katıl: join
Xkatır: mule
kavanoz: jar
Xkay: slide
Xkayak yap: ski
Xkaybet: churn (kaydet daha iyi)
kaydet: save
kaykay: skate
Xkayma: glide (kaynak daha iyi)
Xkayna: boil
kaynak: resource
Xkaynak: source
Xkayıp: miss
Xkayıt: enlist
Xkayıt: record
Xkayıt olmak: enroll
Xkaz: goose
kaza: accident
Xkaza: crash
Xkazan: win
Xkazanan: winner
Xkazanç: gain
Xkaç: flee
Xkaçmak: escape
Xkaçın: avoid
Xkağıt: paper
Xkağıt hamuru: pulp
Xkaş: eyebrow
Xkaşla: roast
Xkaşlarınıçat: frown
Xkaşık: spoon
kedi: cat
Xkedi yavrusu: kitten
Xkek: cake
Xkek: muffin
kelime: word
keman: violin
kemer: arch
Xkemer: belt
kemik: bone
kenar: edge
Xkenar boşluğu: margin
kendi: own
Xkendim: myself
kentsel: urban
kereste: lumber
Xkereste: timber
Xkereviz: celery
kertenkele: lizard
kesin: certain
Xketçap: ketchup
Xkeçi: goat
Xkeşfetmek: discover
kibrit: match
Xkil: clay
kilit: lock
Xkilit: rug
Xkilit aç: unlock
Xkir: dirt
kira: rent
Xkiracı: tenant
Xkirala: hire
Xkiraz: cherry
kirpi: hedgehog
Xkit: kit
kitap: book
kivi: kiwi
Xkişi: person
klinik: clinic
Xklips: clip
koca: husband
Xkod: code
kokla: sniff
koku: odor
Xkol: arm
kolay: easy
Xkolayca: easily
kolon: column
koltuk: seat
komik: comic
konak: mansion
konfor: comfort
kongre: congress
konser: concert
kontrol: control
Xkontrol etmek: check
konu: subject
Xkonumlandır: situate
Xkonuş: speak
Xkonuş: talk
Xkopyala: copy
koridor: aisle
Xkorkmuş: afraid
korku: horror
Xkorkut: scare
korna: horn
koru: protect
Xkoruma: guard
Xkot: jeans
Xkoy: put
Xkoç: coach
Xkoş: run
Xkrallık: kingdom
krater: crater
kredi: credit
krem: cream
kriket: cricket
kristal: crystal
kroki: sketch
kronik: chronic
kuantum: quantum
kucakla: embrace
kule: tower
kullan: employ
Xkullanma: usage
Xkullanılmış: used
Xkullanım: use
Xkullanışlı: useful
Xkullanışsız: useless
Xkulüp: club
Xkum: sand
kumarhane: casino
Xkumaş: cloth
Xkumaş: fabric
Xkumdan tepe: dune
Xkumtaşı: grit
Xkur: setup
kural: rule
Xkurbağa: frog
kurdele: ribbon
kurgu: fiction
kurs: course (kurt daha iyi)
kurt: wolf
Xkurtar: rescue
kuru: dry
Xkurşun: bullet
Xkurşun kalem: pencil
kutsa: bless
kutu: box
Xkutup: pole
Xkutupsal: polar
kuyruk: tail
kuzen: cousin
Xkuzey: north (kuzen daha iyi)
kuzgun: raven
Xkuş: bird
Xkuşatma: siege
Xkâr: profit
Xkök: stem
Xköpek: dog
Xköprü: bridge
Xköpük: foam
Xkör: blind
Xkötü: evil
Xköy: village
Xköylü: peasant
Xkültür: culture
Xküme: cluster
Xküp: cube
Xküre: globe
Xküre: sphere
Xkürek: paddle
Xkütüphane: library
Xküçük: junior
Xküçük: small
Xkıdemli: senior
Xkıkırda: giggle
Xkıkırdama: chuckle
Xkılıç: sword
Xkıpırda: shove
Xkırbaç: whip
Xkırp: trim
Xkırsal: rural
Xkırık: broken
Xkırılgan: fragile
Xkısa: short
Xkısabilgi: brief
Xkıskanç: jealous
Xkısır: vicious
Xkız: girl
Xkızar: blush
Xkızgın: mad
Xkızkardeş: sister
Xkızçocuk: daughter
Xkış: winter
labirent: maze
laboratuvar: lab
lahana: cabbage
lamba: lamp
lastik: rubber
latince: latin
Xlav: lava
Xlens: lens
Xleopar: leopard
lezzet: flavor
Xlif: fiber
liman: harbor
limon: lemon
lisans: license
Xliste: list
liyakat: merit
Xlüks: luxury
Xlütfen: please
Xlütuf: grace
maaş: wage
madalya: medal
madde: matter
Xmadenipara: coin
mahkum: inmate
mahsul: crop
Xmajör: major
makale: essay
Xmakas: scissors
makine: machine
maksimum: maximum
Xmali: fiscal (maliyet daha iyi)
maliyet: cost
malzeme: material
Xmango: mango
mantar: mushroom
Xmantık: logic
manuel: manual
marka: brand
mart: march
masa: desk
Xmasa: table
Xmaske: mask
masum: innocent
matematik: math
Xmatris: matrix
mavi: blue
maymun: monkey
mazeret: excuse
Xmağara: cave
mecbur: oblige
medya: media
mekan: venue
mekanik: mechanic
mektup: envelope
Xmektup: letter
Xmelodi: melody
meltem: breeze
memeli: mammal
memnun: glad
mendil: tissue
Xmenzil: range
Xmenü: menu
merak: wonder
Xmeraklı: curious
mercan: coral
merdiven: ladder
Xmerdivenler: stairs
merhaba: hello
Xmerhamet: mercy
merkez: hub
mermer: marble
mesafe: distance
mesaj: message
Xmetal: metal
metro: subway
Xmeydana gel: emerge
Xmeydan okuma: defy
meyve: fruit
Xmeyve bahçesi: orchard
Xmeyve suyu: juice
Xmeşe: oak
Xmeşgul: busy
mide: stomach
midilli: pony
miktar: amount
milletvekili: deputy
milyon: million
mimik: mimic
minder: cushion
minik: tiny
Xminimum: minimum
Xminör: minor
miras: inherit
mizah: humor
Xmobil: mobile
moda: fashion
Xmodel: model
Xmonitör: monitor
motor: bike
Xmotor: engine
Xmotor: motor
muazzam: immense
mucize: miracle
mutfak: kitchen
Xmutlak: must
mutlu: happy
mutsuz: unhappy
Xmuz: banana
Xmücevher: jewel
Xmüjde: gospel
Xmükemmel: awesome
Xmükemmel: perfect
Xmülk: estate
Xmülk: property
Xmümkün: possible
Xmürettebat: crew
Xmütevazi: humble
Xmüze: museum
Xmüzik: music
Xmüşteri: client
Xmıknatıs: magnet
Xmısır: corn
Xmısırgevreği: cereal
Xnabız: pulse
nadir: rare
naif: naive
nazik: gentle
Xne: what
neden: cause
Xnefes al: inhale
Xnefes nefese: gasp
nemli: damp
neredeyse: almost
Xneredeyse: barely
neresi: where
nesne: object
Xne zaman: when
Xneşe: joy
nisan: april
nokta: point
Xnokta: spot
Xnormal: normal
nostaljik: vintage
Xnot: note
numara: trick
numune: sample
Xnüfus sayımı: census
Xnükleer: nuclear
ocak: stove
Xoda: focus
Xoda: room
odun: wood
ofis: office
Xok: arrow
oksijen: oxygen
okul: school
okyanus: ocean
Xolanak ver: enable
Xolağan: usual
Xolağandışı: unusual
olimpik: olympic
olumsuz: negative
Xoluşma: occur
Xoluştur: render
omuz: shoulder
Xomuz silk: shrug
Xon: ten
onar: repair
onayla: approve
Xonayla: endorse
Xonayla: confirm
Xon iki: twelve
onlar: they
Xon yıl: decade
Xopera: opera
orada: there
oran: rate
ordu: army
Xorgan: organ (orman daha iyi)
orijinal: original
orman: forest
Xorman: jungle
orta: middle
Xortalama: average
Xortaya çıkar: reveal
Xortaya çıkar: uncover
Xortaya çıkarmak: expose
otel: hotel
Xotobüs: bus
otomobil: auto
oturum: session
Xoval: oval
Xoy: vote
oyna: play
oyuk: hollow (oyun daha iyi)
oyun: game
Xoyuncak: toy
Xoyuncak bebek: doll
Xozon: ozone
paket: bundle
pakt: pact
palmiye: palm
Xpalyaço: clown
pamuk: cotton
Xpanda: panda
panik: panic
pano: board
Xpano: panel
panter: panther
Xpapağan: parrot
Xpara kazan: earn
parantez: bracket
Xpark: park
Xparla: shine (parlak daha iyi)
parlak: bright
Xparla: glare
parmak: finger
parti: party
Xparça: piece
Xparçalanmak: crumble
Xparıltı: glow
patates: potato
patern: pattern
Xpatla: burst (patlama daha iyi)
patlama: erupt
Xpatlat: snap
patron: boss
Xpaylaş: share
pazar: market
Xpazarlık: bargain
pelikan: pelican
pembe: pink
pencere: window
Xpençe: claw
perde: curtain
peynir: cheese
Xpeçete: napkin
Xpeşin: cash
piknik: picnic
Xpilot: pilot
pipo: pipe
piramit: pyramid
Xpirinç: brass
Xpirinç: rice
pist: runway
piyango: lottery
Xpiyano: piano
Xpizza: pizza
Xpişmanlık: regret
plaka: plate
Xplastik: plastic
Xpolis: police
Xpopüler: popular
porsiyon: portion
portakal: orange
posta: mail
Xposta: post
pozisyon: position
pratik: practice
Xprogram: program
Xproje: project
puding: pudding
pudra: powder
puro: cigar
Xpürüzsüz: smooth
Xradar: radar
radyo: radio
Xraf: rack
rahatla: relax
Xrahatlama: relief
rakip: rival
rakun: raccoon
ralli: rally
Xrampa: ramp
rapor: report
rastgele: random
reddet: refuse
Xreddet: reject
Xreddetmek: decline
Xreddetmek: deny
rehber: guide
rehin: pledge
renk: color
resim: image
Xresim: picture
Xrisk: risk
ritim: rhythm
Xritüel: ritual
Xrobot: robot
roket: rocket
roman: novel
Xromantizm: romance
rota: route
rozet: badge
Xruh: soul
Xruh: spirit
Xrüya: dream
saat: clock
Xsaat: hour
sabah: morning
sabun: soap
sadece: just
Xsadece: only
Xsadık: loyal
Xsaflık: purity
sahil: beach
Xsahil: coast
Xsahip: owner
sahipol: have
sahne: scene
Xsahne: stage
sakin: calm
salata: salad
Xsaldırı: assault
Xsaldırı: attack
sallan: swing
salon: lounge
Xsalon: salon
sanal: virtual
Xsanat: art
Xsanat eseri: artwork
Xsanatçı: artist
sandalye: chair
saray: palace
Xsarı: yellow
Xsarımsak: garlic
Xsat: sell
Xsatoşi: satoshi
Xsatıcı: vendor
Xsatın al: purchase
Xsavaş: battle
Xsavaşçı: warrior
savunma: defense
sayfa: page
Xsayı: number
Xsaç: hair
Xsaçak: fringe
Xsağ: right
Xsağla: provide
Xsağlık: health
Xsağlık: wealth
sebep: reason
sefalet: misery
Xsegment: segment
sekiz: eight
Xselam ver: salute
sele: saddle
sembol: symbol
Xseminer: seminar
semptop: symptom
sen: you
senaryo: script
sepet: basket
Xserbest bırak: release
sergile: exhibit
Xseri: series
Xserin: cool (series ile aynı)
sersem: dumb
sert: harsh
servet: fortune
Xses: sound
Xses: voice
Xses: volume
sessiz: silent
sevimli: cute
Xseviye: level
seyahat: journey
sezon: season
Xseç: select
Xseçenek: choice
Xseçenek: option
Xseçkin: elite
Xseçmek: choose
silah: gun
Xsilah: weapon
Xsilahlı: armed
Xsil: erase
simge: icon
sincap: squirrel
sinir: nerve
Xsinirli: angry
Xsiren: siren
Xsis: fog
sistem: system
sivil: civil
sivrisinek: mosquito
siyah: black
Xslogan: slogan
Xsoda: soda
sohbet: chat
sokak: alley
Xsokak: street
Xsol: fade
Xsol: left
Xsolar: solar
somon: salmon
Xsomutlaştır: embody
Xson: end
Xson: final
Xsona er: finish
sonbahar: autumn
sonra: then
Xsonraki: next
sonsuz: endless
Xsonsuz: eternal
Xsonuç: result
Xsor: ask
sorgu: inquiry
soru: question
Xsorun: issue
Xsorun: problem
Xsos: sauce
sosis: sausage
sosyal: social
soylu: noble
soyut: abstract
Xsoğan: onion
Xsponsor: sponsor
Xspor: sport
Xspor salonu: gym
Xsprey: spray
Xstabil: stable
Xstadyum: stadium
Xstereo: stereo
stil: style
stok: stock
strateji: strategy
Xsu: water
suistimal: abuse
Xsulu kar: slush
surat: face
Xsuç: crime
Xsuç: guilt
Xsuçla: accuse
Xsuçla: blame
Xsöyle: say
Xsüper: super
Xsüpürge: broom
Xsür: ride
Xsüratli: swift
Xsürdür: sustain
Xsüresidolmak: expire
Xsüreç: process
Xsürgün: exile
Xsürmek: drive
Xsürpriz: surprise
Xsürü: flock
Xsürüklenme: drift
Xsürünmek: crawl
Xsüslemek: decorate
Xsüslü: fancy
Xsüt: milk
Xsıfır: zero
Xsık: frequent
Xsıklıkla: often
Xsıkma: squeeze
Xsıkıcı: boring
Xsınav: quiz
Xsınır: border
Xsınır: limit
Xsıradan: ordinary
Xsırasında: during
Xsıvı: fluid
Xsıvı: liquid
Xsıçrama: bounce
Xsığ: shallow
Xsığınak: bunker
Xsığırlar: cattle
tabak: dish
Xtabanca: pistol
tabla: tray
tabure: stool
Xtad: taste
Xtadını çıkar: enjoy
Xtahmin et: guess
Xtahmin et: predict
Xtahrip et: destroy
Xtahıl: grain
takas: exchange
takip: follow
Xtakip etmek: chase
takla: tumble
Xtaklit: imitate
taksi: taxi
Xtakım: team
Xtakım elbise: suit
talep: demand
tamam: okay
Xtank: tank
Xtanrıça: goddess
Xtanık: witness
tanımla: identify
Xtanımla: define
tara: scan
Xtarif: recipe (tarih daha iyi)
tarih: history
Xtartış: argue
Xtartışma: debate
Xtarçın: cinnamon
Xtasarım: design
taslak: draft
tatil: holiday
Xtatlı: pretty
Xtatlı: sweet
tatmin: satisfy
tavan: ceiling
tavsiye: advice
tavuk: chicken
Xtavuk: hen
Xtavşan: rabbit
taze: fresh
Xtaş: stone
Xtaş: surge
Xtaşımak: carry
Xtebeşir: chalk
tehlike: danger
Xtehlike: hazard
tekerlek: wheel
teklif: offer
Xteklif et: bid
tekme: kick
tekrar: again
Xtekrarla: repeat
Xtel: wire
telefon: phone
tema: theme
tembel: lazy
temel: basic
temiz: clean
Xteneke kutu: can
tenis: tennis
teori: theory
tepe: hill
Xtercih et: prefer
Xtereyağı: butter
terfi: promote
Xterk et: abandon
Xteslim et: deliver
Xtespit et: detect
Xtest: test
tetik: trigger
teyip: tape
Xtezgâh: bench
Xteşekkür: thank
tilki: fox
Xtip: type
tipik: typical
tohum: seed
Xton: tone
Xton balığı: tuna
Xtop: ball
Xtop: cannon
Xtopla: gather (toplam daha iyi)
toplam: total
Xtoplu: bulk
toprak: earth
tortu: clump
tost: toast
Xtoz: dust
trafik: traffic
Xtrajik: tragic
Xtransfer: transfer
Xtrend: trend
trompet: trumpet
Xtur: round
turist: tourist
Xtut: hold
Xtut: keep
tutukla: arrest
tuval: canvas (tuvalet daha iyi)
tuvalet: toilet
tuz: salt
Xtuğla: brick
Xtökezle: stumble
Xtüfek: rifle
Xtükenmişlik: fatigue
Xtünel: tunnel
Xtüp: tube
Xtür: genre
Xtür: kind
Xtüretmek: derive
Xtütün: tobacco
Xtıkabasa: cram
Xtıkanıklık: clog
Xtıkaç: plug
Xtıklamak: click
Xtırmanmak: climb
ucuz: cheap
Xulaş: arrive
ulus: nation
umut: hope
Xunut: forget
usta: master
ustura: razor
Xutangaç: shy
uyan: awake
Xuyandırmak: evoke
uyarı: alert
uygula: enforce
Xuygulamak: execute
Xuyu: sleep
uzak: away
Xuzat: extend
uzay: space
Xuzaylı: alien
Xuzaysal: spatial
Xuzun: limb
uzun: long
Xuzunluk: length
Xuç: fly
Xuçurtma: kite
Xuçurum: cliff
Xuçuş: flight
vadi: valley
vagon: wagon
Xvahşi: wild
vakum: vacuum
valf: valve
vardiya: shift
varil: barrel
Xvarlık: asset
Xvar ol: exist
Xvatandaş: citizen
Xver: give
Xversiyon: version
Xvideo: video
Xvinç: crane
Xvirüs: virus
vize: visa
vokal: vocal
volkan: volcano
Xvücut: body
Xvızıltı: buzz
Xyaban arısı: wasp
yakala: grab
Xyakala: tackle
Xyakalamak: catch
Xyakalanmış: caught
Xyakın: near
Xyakında: soon
Xyakıt: fuel
Xyalancı: liar
Xyalnız: alone
Xyalnız: lonely
yama: patch
Xyan: side
Xyanlış: false
Xyanlış: wrong
Xyansıt: reflect
Xyanıt: response
Xyap: make
Xyapabilme: able
yapboz: puzzle
yaprak: leaf
Xyardım: assist
Xyardım: help
Xyargıç: judge
Xyarım: half
Xyarın: tomorrow
Xyarış: race
Xyas: grief
Xyasadışı: illegal
yasal: legal
Xyasallaştır: enact
Xyatır: deposit
Xyatırım: invest
Xyavaş: slow
Xyavru köpek: puppy
Xyaygın: common
Xyayıl: spread
Xyaz: summer
Xyaz: write
yazar: author
Xyazı: text
Xyağ: fat
Xyağ: oil
Xyağmur: rain
Xyaş: age
Xyaşlı: elder
yedi: seven
yelken: sail
yemin: swear
Yeniden aç: reopen
Xyeniden birleşme: reunion
Xyeniden inşaet: rebuild
yenile: renew
Xyer: place
Xyer değiştir: replace
yerel: local
yerine: rather
Xyerleş: settle
Xyerçekimi: gravity
yetenek: skill
Xyetenek: ability
Xyetenek: talent
Xyetenekli: capable
Xyeterli: enough
yetim: orphan
Xyetişkin: adult
Xyetiştir: fit
yetki: mandate
Xyeğen: nephew
Xyeşil: green
yirmi: twenty
yiyecek: food
Xyok ol: vanish
yoksulluk: poverty
Xyol: path
Xyol: road
Xyol: way
yolculuk: voyage
Xyol: pluck
yorgun: tired
yumruk: punch
yumurta: egg
Xyumurtla: spawn
Xyumuşak: soft
yunus: dolphin
Xyut: swallow
yuva: nest
Xyönetmek: conduct
Xyönetmek: govern
Xyönlendirmek: divert
Xyöntem: method
Xyörünge: orbit
Xyüce: supreme
Xyük: burden
Xyük: load
Xyüksek: high
Xyükseklik: height
Xyüksekses: loud
Xyün: wool
Xyürümeyebaşlayançocuk: toddler
Xyürüyüş: walk
Xyüz: hundred
Xyüz: swim
Xyüzey: surface
Xyüzyıl: century
Xyüzük: ring
Xyıka: flush
Xyıkama: wash
Xyıl: year
Xyılan: snake
Xyıllık: annual
Xyığın: chunk
Xyığın: mass
zafer: victory
zaman: time
zamk: glue
zanaat: craft
Xzar: dice
zarar: damage
Xzarar ver: inflict
zarif: elegant
Xzayıf: slim
Xzebra: zebra
zemin: floor
zencefil: ginger
zengin: rich
Xzenginleştir: enrich
zeytin: olive
ziyaret: visit
Xzor: hard
Xzürafa: giraffe
Xzıpla: jump
Xzırh: armor
Xçabala: struggle
Xçabuk: quick
Xçadır: tent
Xçakal: coyote
Xçalışma: exercise
Xçamaşır: laundry
Xçanta: bag
Xçapa: anchor
Xçaresizlik: despair
Xçarp: multiply
Xçarp: slam
Xçatal: fork
Xçatı: roof
Xçatırtı: crack
Xçatırtı: crunch
Xçaylak: rookie
Xçayır: meadow
Xçağ: era
Xçek: pull
Xçekirdek: core
Xçekiç: hammer
Xçelik: steel
Xçerçeve: frame
Xçevir: flip
Xçevrele: surround
Xçevrimiçi: online
Xçeyrek: quarter
Xçeşitli: various
Xçift: couple
Xçift: double
Xçift: fence
Xçift: pair
Xçiftlik: farm
Xçiftlik: ranch
Xçim: lawn
Xçimen: grass
Xçimento: cement
Xçirkin: ugly
Xçizgi: dash
Xçizmek: draw
Xçiçek: flower
Xçiçekaç: blossom
Xçocuk: child
Xçocuk: kid
Xçok: very
Xçoktan: already
Xçorap: sock
Xçorba: soup
Xçubuk: bar
Xçubuk: stick
Xçöl: desert
Xçömelmek: crouch
Xçömlek: pottery
Xçöp: garbage
Xçöp: trash
Xçöz: solve
Xçözüm: solution
Xçünkü: because
Xçıkar: omit
Xçıktı: output
Xçıkıntı: ridge
Xçıkış: exit
Xçıtır: crisp
Xödeme: payment
Xödül: prize
Xödül: reward
Xödül: trophy
Xödünçver: lend
Xöfke: anger
Xöfke: fury
Xölçek: beef
Xölçek: before
Xölçek: scale
Xölçer: gauge
Xölçüm: measure
Xölüm: demise
Xölümcül: fatal
Xön: front
Xöncelik: primary
Xöncü: pioneer
Xönde: ahead
Xönder: leader
Xönem: priority
Xöner: suggest
Xönle: prevent
Xöpücük: kiss
Xördek: duck
Xörgü: mesh
Xörnek: example
Xörtüsünüaç: unveil
Xörümcek: spider
Xöte: beyond
Xöv: praise
Xöz: essence
Xözel: private
Xözel: special
Xözellik: feature
Xözgürlük: liberty
Xözür: apology
Xöğe: element
Xöğe: item
Xöğleyemeği: lunch
Xöğren: learn
Xöğrenci: pupil
Xöğrenci: student
Xöğret: teach
Xücret: fee
Xülke: country
Xüniforma: uniform
Xüniversitemezunu: bachelor
Xünlü: famous
Xüret: produce
Xürperti: shiver
Xüst: upper
Xüstesindengel: manage
Xüstünde: top
Xütü: iron
Xüye: member
Xüzerinde: above
Xüzerinden: over
Xüzerine: upon
Xüzerinegel: hover
Xüzgün: sad
Xüzgün: sorry
Xüzgün: upset
Xüzüm: grape
Xüzüntü: sadness
Xüç: three
Xılık: warm
Xıslak: wet
Xıstakoz: lobster
Xışık: light
Xşaba: effort
Xşafak: dawn
Xşaft: shaft
Xşahin: hawk
Xşair: poet
Xşaka: joke
Xşampiyon: champion
Xşanslı: lucky
Xşapka: hat
Xşarap: wine
Xşarj: charge
Xşarkı: song
Xşarkısöyle: sing
Xşarkısözü: lyrics
Xşef: chef
Xşehir: city
Xşehir: town
Xşehriye: noodle
Xşeker: candy
Xşeker: sugar
Xşema: scheme
Xşemsiye: umbrella
Xşen: merry
Xşerif: sheriff
Xşey: stuff
Xşey: thing
Xşiddetli: drastic
Xşiir: poem
Xşimdi: now
Xşimdiki: current
Xşimşek: thunder
Xşirket: company
Xşok: shock
Xşu: that
Xşubat: february
Xşurup: syrup
Xşöhret: fame
Xşüphe: suspect
Xşımar: spoil
